#"Try and"# is common in colloquial speech, but #"try to"# is recommended for writing.	#“try and”#常用于口语，但写作建议用#“try to”#。
#"needs cut"# is only accepted in certain dialects. For something more widely acceptable, try #"cut" or "to be cut"#.	#“needs cut”#常出现在某些方言中。更广泛使用的是#“cut”或“to be cut”#。
#'Also'# is not used at the end of the sentence. Use #"as well"# instead.	#“also”#一般不用于句尾。通常用#“as well”#代替。
#'Each', 'every', 'either' and 'neither'# are used with singular and thus take a singular pronoun: #"his", "her", "his or her", "its"#	 #“each”、“every”、“either”和“neither”#与单数一起使用，因此取单数代词：#“his”、“her”、“his or her”、“its”#
#'Each', 'every', 'either' and 'neither'# are used with singular. Did you mean #"all"#?	#“each”、“every”、“either”和“neither”#与单数一起使用。你的意思是#“all”#？
#'Everyday'# is an adjective, and the comma is missing. Did you mean #"every day, I"#?	#“Everyday”#是一个形容词，没有逗号。你是要表达#"every day, I"吗#？
#'Everyday'# is an adjective. Did you mean #"every day"#?	#“Everyday”#是一个形容词。你是想说#“every day”#？
#'Going to'# requires the base form: #"be"#	#“Going to”#需要基本形式：#“be”#
#'Say'# cannot be followed by a direct personal object. Did you mean #"tell"#?	#'Say'#后面不能跟直接的个人物品。你是说#tell#吗？
#'So as to'# expresses purpose and is used in formal texts. Consider using #"to"#	#“So as to”#表示目的，并在正式文本中使用。考虑使用#“to”#
#'afraid'# is not a verb. You should rather write: #"You're not afraid"#.	#afraid#不是动词。你应该写下：#You're not afraid#。 
#'combine together'# is redundant. Use #"combine"#	#“combine together”#是多余的。使用#“combine”#
#'woman'# is the singular form of #'women'#. Consider using #"woman"#.	#“woman”#是#“women”#的单数形式。考虑使用#“woman”#。
A comma should precede the tag question (i.e., the yes/no-question at the end).	标记问题（即结尾的是/否问题）前应加逗号。
A determiner cannot combine with a possessive pronoun. Did you mean simply #"Its of" or "a of"#.	限定词不能与所有格代词结合。你的意思是#"Its of" or "a of"#呢？
A determiner is probably missing here: #", the Doest"#.	这里可能缺少一个威慑者：#", the Doest"#。
A more concise phrase may lose no meaning and sound more powerful.	 一个更简洁的短语可能失去意义，听起来更有力。
A new year has begun. Did you mean #"July 13, 2019"#?	新年已经开始。你是说#"July 13, 2019"#吗？
A noun should not follow #'who'#. Try changing to a verb or maybe to #"who is a als"#.	 名词不应跟在#'who'#后面。试着换一个动词，或者换成#"who is a als"#。
A verb is probably missing after #'Twice'#.	#'Twice'#后可能缺失动词。
Add a space between sentences	在句子之间需要添加空格
Adverb repetition. Please, verify.	 请核实副词是否重复。
After #'must'#, the verb is used without #'to'#. Probably, you should use #"must"# or #"have to"# here.	#'must'#动词后面不带#'to'#。可能应该在这里使用#“must”#或#“have to”#。
After #'some of'#, you should use #'the'# #("some of the classmates")# or simply say #"some classmates"#.	在#'some of'#之后，你应该使用#“the”##("some of the classmates")#或者简单地说#“some classmates”#。
An apostrophe is never used to form possessive case pronouns. Did you mean: #"His"#?	撇号从不用来构成所有格代词。你的意思是：#“His”#？
Apostrophe might be missing. Did you mean #"Chines'" or "chine's"#?	可能缺失撇号。你是说#"Chines'" or "chine's"#？
Apostrophes aren't needed for decades: #"80s"#.	几十年代不需要撇号：#“80s”#。
Are you writing a letter? Did you mean "Dear"?	你在写信吗？你是说“Dear”？
Capitalize holidays.	假日大写。
Capitalize specific historic events, episodes, and eras.	将特定的历史事件、事件和时代大写。
Commas set off the month in a weekday-month-day date: #"Sunday,"#.	逗号在工作日、月日、星期日、#"Sunday,"#中抵消了月份。
Comparison is written #'the same ... "as"'#.	比较是写为#"the same ... as"#
Comparison requires #"than"#, not #'then'# nor #'as'#.	比较常用#“than”#，而不是#“then”#，也不是#“as”#。
Consider replacing #"In a fun way"# with the adverb for #"fun"#; e.g., #"in a hasty manner" with "hastily"#.	考虑替换掉#"In a fun way"#而使用副词#"fun"#，例如:#"in a hasty manner" with "hastily"#。 
Consider shortening this phrase to just #"whether"#, or rephrase the sentence to avoid #"the question"#.	考虑将这个短语缩短为#“whether”#，或者重新措辞这个句子以避免#“the question”#。
Consider shortening this phrase to just #"whether"#. It is correct though if you mean #'regardless of whether'#.	 考虑将这个短语缩短为#“whether”#。不过，如果你的意思是#“regardless of whether”#。
Consider using #"All Greeks" or "All of the Greeks"#.	考虑使用#"All Greeks" or "All of the Greeks"#。
Consider using #"many"#.	考虑使用#"many"#。
Consider using #"some student" or "some of the student"#.	考虑使用#"some student" or "some of the student"#。
Consider using a past participle here: #"absorbed"#.	考虑在这里使用过去分词：#"absorbed"#。
Consider using the base form #"be"#.	 考虑使用基本形式#"be"#。 
Consider using the past participle #"busied"#?	 考虑使用过去分词#"busied"#？
Consider using the plural form here: #"Plats"#.	 请考虑在此处使用复数形式：#"Plats"#。
Consider using third-person verb forms for singular and mass nouns: #"asks"#.	 考虑将第三人称动词形式用于单数和大量名词：#"asks"#。
Did you forget a comma after a conjunctive/linking adverb?	你忘了在连接副词后加逗号了吗？
Did you forget something after #'An'#?	#'An'#之后你忘了什么吗？
Did you mean #"At me", "At her", "At him", "At us", or "At them"#?	你的意思是#"At me", "At her", "At him", "At us", or "At them"#吗？
Did you mean #"Could"#?	你的意思是#"Could"#吗？
Did you mean: #"Could"#?	你的意思是#"Could"#吗？
Did you mean #"Despite"# (or, alternatively, #'in spite of'#)?	你的意思是#"Despite"#（或者说，#'in spite of'#）吗？
Did you mean #"For me", "For her", "For him", "For us", or "For them"#?	你的意思是#"For me", "For her", "For him", "For us", or "For them"#？
Did you mean #"Hallo"#, the greeting? A halo is an optical phenomenon.	你是说#"Hallo"#，问候语吗？光晕是一种光学现象。
Did you mean #"If"# or is a comma missing #("I,")#?	您的意思是#"If"#还是缺少逗号#("I,")#？
Did you mean #"It's"# (=#"It has"#) instead of #"its"# (possessive pronoun)?	你的意思是#"It's"#（=#"It has"#）而不是#"its"#（所有格代词）？
Did you mean #"It's"# (=#"It is"#) instead of #'its'# (possessive pronoun)?	你的意思是#"It's"#（=#"It is"#）而不是#"its"#（所有格代词）？
Did you mean "Let's" (let's = let us; lets = 3rd person singular of 'let')?	你的意思是“让我们”（让我们=让我们；让我们=第三人称单数“让”）吗？
Did you mean "Lets" or "Let" (let's = let us; lets = 3rd person singular of 'let')?	你的意思是“让”还是“让”（让我们=让我们；让我们=第三人称单数“让”）？
Did you mean #"Merry" (=jolly, festive)#?	你是说#"Merry" (=jolly, festive)#吗？
Did you mean #"am" or "ate"#?	你的意思是#"am" or "ate"#？
Did you mean #"am", "are", "aren"#? Alternatively, check whether the singular of #'Students'# should be used.	你的意思是#"am", "are", "aren"#吗？或者，检查是否应使用#'Students'#的单数形式。
Did you mean #"am"#?	你的意思是#"am"#吗？
Did you mean #"and so on" (='etc.')#?	你的意思是#"and so on" (='etc.')#吗？
Did you mean #"arriving"#? Or maybe you should add a pronoun? In active voice, #'allow' + 'to'# takes an object, usually a pronoun.	你是说#"arriving"#？或者你应该加一个代词？在主动语态中，#'allow' + 'to'#取一个宾语，通常是代词。 
Did you mean #"being"#? Or maybe you should add a pronoun? In active voice, #'order' + 'to'# takes an object, usually a pronoun.	你是说#"being"#？或者你应该加一个代词？在主动语态中，#'order' + 'to'#取一个宾语，通常是代词。
Did you mean #"belief" (noun)# instead of #believe (verb)#?	你的意思是#"belief" (noun)#而不是#believe (verb)#？
Did you mean #"calendar"#, a system of organizing days? A 'calender' is a machine.	你的意思是#"calendar"#，一个组织日子的系统吗？“日历”是一台机器。
Did you mean #"care"#? Alternatively, check whether the singular of #"others"# should be used.	你的意思是#"care"#？或者，检查是否应使用#"others"#的单数形式。
Did you mean #"cheat"#? Alternatively, check whether the singular of #"students"# should be used.	你是说#"cheat"#？或者，检查是否应使用#'students'#的单数。
Did you mean #"cheating"#? Or maybe you should add a pronoun? In active voice, #'allow' + 'to'# takes an object, usually a pronoun.	你是说#"cheating"#？或者你应该加一个代词？在主动语态中，#'allow' + 'to'#取一个宾语，通常是代词。
Did you mean #"come"#? Alternatively, check whether the singular of #'friends'# should be used.	你是说#"come"#吗？或者，检查是否应使用#'friends'#的单数。
Did you mean #"competing"#? Or maybe you should add a pronoun? In active voice, #'order' + 'to'# takes an object, usually a pronoun.	你的意思是#"competing"#？或者你应该加一个代词？在主动语态中，#'order' + 'to'#取一个宾语，通常是代词。
Did you mean #"contact" (=muscular organ)#?	你的意思是#"contact" (=muscular organ)#？
Did you mean #"contain"#? As #'do'# is already inflected, the verb cannot also be inflected.	你的意思是#"contain"#？因为#'do'#已经变形，所以动词也不能变形。
Did you mean #"despite"# (or, alternatively, #'in spite of'#)?	你的意思是#"despite"#（或者说，#'in spite of'#）吗？
Did you mean #"displaying"#? Or maybe you should add a pronoun? In active voice, #'require' + 'to'# takes an object, usually a pronoun.	你的意思是#"displaying"#？或者你应该加一个代词？在主动语态中，#'require' + 'to'#取一个宾语，通常是代词。
Did you mean #"do"#? #'does'# is only used for the third person singular #(he/she/it)#.	你是说#"do"#吗？#'does'#仅用于第三人称单数#(he/she/it)#。
Did you mean #"doing"#? Or maybe you should add a pronoun? In active voice, #'allow' + 'to'# takes an object, usually a pronoun.	你是说#"doing"#吗？或者你应该加一个代词？在主动语态中，#'allow' + 'to'#取一个宾语，通常是代词。
Did you mean #"felt"#? Alternatively, check whether the singular of #'people'# should be used.	你的意思是#"felt"#？或者，检查是否应使用#'people'#的单数。
Did you mean #"fewer"#? The noun #dramas# is countable.	你的意思是#"fewer"#吗？名词#dramas#是可数的。
Did you mean #"fighting"#? Or maybe you should add a pronoun? In active voice, #'allow' + 'to'# takes an object, usually a pronoun.	你是说#"fighting"#？或者你应该加一个代词？在主动语态中，#'allow' + 'to'#取一个宾语，通常是代词。
Did you mean #"for"#? (#'since'# refers to a point in time, whereas #'for'# refers to a period)	你的意思是#"for"#？（#'since'#指时间点，而#'for'#指周期）
Did you mean #"from me", "from her", "from him", "from us", or "from them"#?	你的意思是#"from me", "from her", "from him", "from us", or "from them"#？
Did you mean #"going", "gonna"#? Or maybe you should add a pronoun? In active voice, #'teach' + 'to'# takes an object, usually a pronoun.	你的意思是#"going", "gonna"#吗？或者你应该加一个代词？在主动语态中，#'teach' + 'to'#取一个宾语，通常是一个代词。
Did you mean #"grandparent's"# or #"grandparents'"#?	你是指#"grandparent's"# or #"grandparents'"#？
Did you mean #"have", "haven"#? Alternatively, check whether the singular of #'students'# should be used.	你的意思是#"have", "haven"#吗？或者，检查是否应使用#'students'#的单数形式。
Did you mean #"have"#? (#'should of'# is probably an incorrect use of the verb phrase #'should have'#; as contraction #"should've"# sounds like #"could of"#)	你是说#"have"#？（#'should of'#可能是动词短语#'should have'#的错误用法；因为缩写#"should've"#听起来像#"could of"#）。
Did you mean #"heard"# (past tense of #'hear'#)?	你的意思是#“heard”#（#“hear”#的过去时）吗？
Did you mean #"help"#? As #'do'# is already inflected, the verb cannot also be inflected.	你是说#"help"#吗？因为#'do'#已经变形，所以动词也不能变形。
Did you mean #"helping"#? Or maybe you should add a pronoun? In active voice, #'order' + 'to'# takes an object, usually a pronoun.	你是说#"helping"#吗？或者你应该加一个代词？在主动语态中，#'order' + 'to'#取一个宾语，通常是代词。
Did you mean #"it's"# (=#"it is"#) instead of #'its'# (possessive pronoun)?	你的意思是#"it's"#（=#"it is"#）而不是#'its'#（所有格代词）？
Did you mean #"it's"# (=#it is#) instead of the possessive pronoun #'its'#?	你的意思是#"it's"#(=#it is#)而不是#'its'#所有格代词吗？
Did you mean #"its"# (possessive pronoun) instead of #'it's'# (=#it is#)?	你的意思是#"its"#（所有格代词）而不是#'it's'# (=#it is#)？
Did you mean #"its"# (possessive pronoun) instead of #'it's'# (short form of #'it is'#)?	你是指#"its"#（所有格代词）而不是#'it's'#（#'it is'#简称）吗？
Did you mean #"its"# (possessive pronoun)?	你的意思是#"its"#（所有格代词）？
Did you mean #"keeping"#? Or maybe you should add a pronoun? In active voice, #'advise' + 'to'# takes an object, usually a pronoun.	你是说#"keeping"#？或者你应该加一个代词？在主动语态中，#'advise' + 'to'#取一个宾语，通常是一个代词。 
Did you mean #"knew"# (past of #'to know'#)?	你的意思是#"knew"#（过去的#'to know'#）吗？
Did you mean #"laugh"#? Alternatively, check whether the singular of #'men'# should be used.	你是说#"laugh"#吗？或者，检查是否应使用#'men'#的单数。
Did you mean "let's" (let's = let us; lets = 3rd person singular of 'let')?	你的意思是“让我们”（让我们=让我们；让我们=第三人称单数“让”）吗？
Did you mean "lets" or "let" (let's = let us; lets = 3rd person singular of 'let')?	你的意思是“让”还是“让”（让我们=让我们；让我们=第三人称单数“让”）？
Did you mean #"live"#? Alternatively, check whether the singular of #'people'# should be used.	你是说#"live"#吗？或者，检查是否应使用#'people'#的单数。
Did you mean #"lose" (= miss, waste, suffer the loss etc.)#?	你的意思是#"lose" (= miss, waste, suffer the loss etc.)#吗？
Did you mean #"meantime"# (=#the period of time between two things#).	你的意思是#"meantime"#（=#the period of time between two things#）吗？
Did you mean #"messing"#? Or maybe you should add a pronoun? In active voice, #'allow' + 'to'# takes an object, usually a pronoun.	你是说#"messing"#吗？或者你应该加一个代词？在主动语态中，#'allow' + 'to'#取一个宾语，通常是代词。
Did you mean #"need"#? Alternatively, check whether the singular of #'tourists'# should be used.	你是说#"need"#？或者，检查是否应使用#'tourists'#的单数。
Did you mean #"now"# (=#at this moment#) instead of #'no'# (negation)?	你的意思是#"now"#(=#at this moment#)而不是#'no'#（否定）？
Did you mean #"of course"# (=#naturally#)?	你的意思是#"of course"#（=#naturally#）？
Did you mean #"on November"#? This seems to be a day date.	你的意思是#"on November"#吗？这似乎是一天的约会。
Did you mean #"on behalf" (in the name of, as a representative of)#?	你的意思是#"on behalf" (in the name of, as a representative of)#？
Did you mean #"on its obvious"#?	你的意思是#"on its obvious"#？
Did you mean #"overtime"# (=#time someone works beyond normal working hours#)?	你的意思是#"overtime"#（=#time someone works beyond normal working hours#）？
Did you mean #"parent's" or "parents'"#?	你是指#"parent's" or "parents'"#？
Did you mean #"quite"#? #'quiet'# means #'silent'#, #'quite'# mean #'very'# or #'to a moderate extent'#	你的意思是#"quite"#吗？#'quiet'#是指#'silent'#，#'quite'#是指#'very'#或#'to a moderate extent'#
Did you mean #"share"#? Alternatively, check whether the singular of #'students'# should be used.	你的意思是#"share"#？或者，检查是否应使用#'students'#的单数。 
Did you mean #"somewhat"# (=#slightly#)?	你的意思是#"somewhat"#（=#slightly#）？
Did you mean #"studying"#? Or maybe you should add a pronoun? In active voice, #'require' + 'to'# takes an object, usually a pronoun.	你是说#"studying"#吗？或者你应该加一个代词？在主动语态中，#'require' + 'to'#取一个宾语，通常是代词。
Did you mean #"teach"#? As #'do'# is already inflected, the verb cannot also be inflected.	你是说#"teach"#？因为#'do'#已经变形，所以动词也不能变形。
Did you mean #"than"#? #'than'# is used for comparisons, #'then'# is an expression of time.	你的意思是#"than"#？#'than'#用于比较，#'then'#是时间的表达式。
Did you mean #"want"#? Alternatively, check whether the singular of #'students'# should be used.	你是说#"want"#？或者，检查是否应使用#'students'#的单数。
Did you mean #"were"#, the simple past of #"to be"#?	你的意思是#"were"#，#"to be"#的简单过去吗？
Did you mean #"who"# instead of #'whom'#.	你的意思是#"who"#而不是#'whom'#。
Did you mean #"will ,"# or is a hyphen missing #"ill-,"# (e.g., #ill-treated, ill-advised#)?	你的意思是#"will ,"#，or is a hyphen missing，#“ill-，”#（例如，#虐待，不明智#）？
Did you mean #"will be" or "has been"#?	你的意思是#"will be" or "has been"#？
Did you mean #"working"#? Or maybe you should add a pronoun? In active voice, #'encourage' + 'to'# takes an object, usually a pronoun.	你是说#"working"#吗？或者你应该加一个代词？在主动语态中，#'encourage' + 'to'#取一个宾语，通常是代词。
Did you mean #'different "from"'#? #'Different than'# is often considered colloquial style.	你的意思是#'different "from"'#吗？#'Different than'#通常被认为是口语风格。
Did you mean simply #"consider all"#? You do not need the word #"about"# here.	你的意思是简单地#"consider all"#吗？这里不需要#"about"#这个词。
Did you mean the adjective #"Chinese-speaking"#?	你是指形容词#"Chinese-speaking"#吗？
Did you mean the adverb #"well"#?	你是说副词#"well"#吗？
Did you mean the noun #"cleanup"# instead of the phrasal verb #'clean up'#?	你是指名词#"cleanup"#而不是短语动词#'clean up'#吗？
Did you mean the plural instead of the possessive?	你的意思是复数而不是所有格？
Did you mean to refer to the current year? #February 20th, 2019# is not #a Sunday#, but #a Wednesday#.	你是指当年吗？#February 20th, 2019#不是#a Sunday#，而是#a Wednesday#。
Don't include #'a'# after a classification term. Use simply #"kind of"#.	不要在分类术语后包含#'a'#。简单使用#"kind of"#。
Don't put a space after the opening parenthesis	不要在左括号后加空格
Don't put a space before the full stop	不要在全站前留出空间
Don't use indefinite articles with plural words. Did you mean #"an activity"# or simply #"activities"#?	不要使用带有复数词的不定冠词。你是指#"an activity"#还是简单的#"activities"#？ 
Don't use indefinite articles with plural words. Did you mean #"animal"#?	不要使用带有复数词的不定冠词。你是说#"animal"#吗？
Double negatives are discouraged in standard English. Can you reformulate this phrase or is a comma missing?	标准英语不鼓励双重否定。你能重新表述这个短语吗？还是缺少逗号？
Duplicated #'the'# in the phrase: #'the Paly the'#. Did you mean #"Paly the"#?	在短语中复制了#'the'#：#'the Paly the'#。你的意思是#"Paly the"#？
For negated sentences, use #"either"# instead of #'too'#.	对于否定句，使用#"either"#而不是#'too'#。
If #" if"# starts an indirect question, you do not need to put a comma before it.	如果#" if"#开始一个间接问题，您不需要在它前面加逗号。
If #'Learning'# is used as a verb, it usually requires the infinitive: #"to paint"#.	如果#'Learning'#用作动词，则通常需要不定式来#"to paint"#。
If #'people'# is plural here, don't use the third-person singular verb.	如果#'people'#在这里是复数，不要使用第三人称单数动词。
If the text is a generality, 'of the' is not necessary. Do you mean "some"?	如果文本是一般性的，则不需要“of the”。你是说“一些”？
If you mean a great quantity, use #"A lot of kind"#?	如果你的意思是大量的，使用#"A lot of kind"#吗？ 
In English, people don't say #"interested by'#. They say, #"interested in'#.  Did you mean #"interested in"#?	在英语中，人们不会说#"interested by'#。他们说，#"interested in'#。你的意思是#"interested in'#吗？
In English, the normal collocation for #"party"# is #"have"# or #"throw"#. Revise your sentence: #"to throw a party" or "to have a party"#.	在英语中，#"party"#的正常搭配是#"have"#或#"throw"#。修改你的句子：#"to throw a party" or "to have a party"#。
In formal / written English, it is recommended that you use a subject pronoun.	在正式/书面英语中，建议使用主语代词。
In the grammatical structure #'look + forward + to + verb'#, the verb #'to'# is used with the gerund: #"to appreciating"#.	在语法结构#'look + forward + to + verb'#中，动词#'to'#与动名词一起使用：#"to appreciating"#。
In the grammatical structure #'pronoun + be/get + used + to + verb'#, the verb #'used'# is used with the gerund: #"used to being"#.	在语法结构#'pronoun + be/get + used + to + verb'#中，动词#'used'#与动名词一起使用：#"used to being"#。
Incorrect form of the pronoun #'I'#. Use: #"between me"#.	代词#'I'#的形式不正确。使用：#"between me"#。
Incorrect phrase. Use #"very well-known"# or #"well-known"# instead.	不正确的短语。用#"very well-known"#或#"well-known"#代替。
Incorrect plural form; it does not need any apostrophe. Did you mean #"Amerias"#?	复数形式不正确；它不需要任何撇号。你的意思是#"Amerias"#？
Incorrect singular possessive form after the number #(two)#. Did you mean #"days"# or #"days'"#?	数字#(two)#后的单数所有格形式不正确。你的意思是#"days"#还是#"days'"#？
Interjections are usually punctuated.	感叹词通常加标点。
Is this the personal pronoun #'I'#? It is spelled uppercase.	这是人称代词#'I'#吗？它是大写的。
It's never correct to use #'of'# after a modal verb. Use #"may have"#, or, in informal register, #"may've"#.	在情态动词后使用#'of'#永远不正确。使用#"may have"#，或在非正式登记簿中使用#"may've"#。
Make sure that #'Fr'# is an abbreviation for #'Father' or the element francium#. Do you mean #"For"#?	确保#'Fr'#是#'Father' or the element francium#的缩写。你的意思是#"For"#？
Make sure that #'Th'# is the chemical symbol for #thorium#, and not a typing error. Did you mean #"The"#?	确保#'Th'#是#thorium#的化学符号，而不是输入错误。你的意思是#"The"#？
Make sure that #'au'# means #'astronomical unit'#. If you mean the chemical symbol for #gold#, use #"Au"#.	确保#'au'#表示#'astronomical unit'#。如果你是指#gold#的化学符号，用#"Au"#。
Make sure that #'fr'# means #'franc'#. Do you mean #"for"#?	确保#'fr'#的意思是#'franc'#。你的意思是#"for"#？
Maybe a wrong construction: #a/the + infinitive#	可能是构造错误：#a/the + infinitive#
Maybe you need to remove one determiner so that only #"A"# or #"A"# is left.	也许你需要去掉一个洗涤剂，这样就只剩下#"A"#或#"A"#。
Maybe you need to remove the second determiner so that only #"A"# or #"this"# is left.	也许你需要移除第二个去污剂，这样就只剩下#"A"#或#"this"#。
Maybe you should omit the article #'a'#, leaving only #"much"#.	也许你应该省略冠词#'a'#，只留下#"much"#。
Non-standard use of the comparative or superlative. Did you mean #"least much"#?	比较级或最高级的非标准用法。你的意思是#"least much"#吗？
Nonstandard phrase. Did you mean: #"From 1 to 0"#?	非标准短语。你的意思是：#"From 1 to 0"#？
Note: #went# is a past participle of #"wend"#. Did you mean #"gone"# (past participle of #"go"#)?	注：#went#是#"wend"#的过去分词。你的意思是#"gone"#（#"go"#的过去分词）？
One of these determiners is redundant in this context. Choose only one: #"a room" or "another room"#.	在这种情况下，其中一个威慑者是多余的。只选择一个：#"a room" or "another room"#。
Only in a nautical context #'payed'# is an acceptable past tense form of #'pay'#. Please check!	只有在航海上下文中，#'payed'#才是#'pay'#的可接受的过去时形式。请核对一下！
Please check if the base form of the verb should be used here.	请检查此处是否应使用动词的基本形式。
Please check the order of words and the punctuation of this sentence!	请检查单词的顺序和这句话的标点符号！
Please check the suffix, if this is an ordinal number.	如果这是一个序数，请检查后缀。
Please check whether #'Both of them'# should be followed by a plural form: #"contain"#	请检查#'Both of them'#后是否应加上复数形式：#"contain"#
Please check whether #'to'# is missing here (to allow to do something).	请检查此处是否缺少#'to'#（允许执行某些操作）。
Please check whether a plural form of #'poetry'# should be used.	请检查是否应使用#'poetry'#的复数形式。
Please check whether a verb is missing here or whether #'there'# should be #'their'#.	请检查此处是否缺少动词，或#'there'#是否应为#'their'#。
Please check whether a verb is missing here.	请检查这里是否缺少动词。
Please check whether a word is missing between #'the'# and #'was'# or whether #'the'# is the correct determiner.	请检查#'the'#和#'was'#之间是否漏掉了一个词，或者#'the'#是否是正确的限定词。
Please check whether an article is missing: #"a Chinese"#.	请检查是否丢失冠词：#"a Chinese"#。
Please check whether an object form is required here.	请检查此处是否需要对象窗体。
Please check whether one of these words is redundant.	请检查这些单词中是否有一个是多余的。
Please check whether the nominative #"He"# should be used.	请检查是否应使用提名的#"He"#
Possible agreement error	可能的协议错误
Possible agreement error - use third-person verb forms for singular and mass nouns: #"appears"#.	可能的一致性错误-使用第三人称动词形式表示单数和量词：#"appears"#。
Possible agreement error -- use past participle here: #"armed"#.	可能的协议错误--请在此处使用过去分词：#"armed"#。
Possible agreement error -- use verb form: #"live"#.	可能的协议错误——使用动词形式：#"live"#。
Possible agreement error. Consider using: #"one thousand"#	可能的协议错误。考虑使用#"one thousand"#
Possible agreement error. Did you mean #"years"?#	可能的协议错误。你是说#"years"?#吗？
Possible agreement error. Do you mean #"becomes"#? (Some collective nouns can be treated as both singular and plural, so #'become'# is not always incorrect.)	可能的协议错误。你的意思是#"becomes"#？（有些集合名词可以同时看作单数和复数，因此#"becomes"#并不总是错误的。）
Possible agreement error. The noun #'yes'# seems to be countable, so consider using: #"yeses"#, #"yesses"#.	可能的协议错误。名词“#'yes'#似乎是可数的，所以考虑使用：#"yeses"#, #"yesses"#。
Possible agreement error. The noun #Beer# seems to be countable; consider using: "many beers".	可能的协议错误。#Beer#这个名词似乎是可数的；考虑使用"many beers"。
Possible agreement error. The noun #boniness# seems to be uncountable; consider using: #"much boniness", "a good deal of boniness"#.	可能的协议错误。名词#boniness#似乎不可数；可以考虑使用：#"much boniness", "a good deal of boniness"#。
Possible agreement error. The noun #person# seems to be countable; consider using: #"Many people", "Many persons"#.	可能的协议错误。名词#person#似乎是可数的；考虑使用：#"Many people", "Many persons"#。
Possible agreement error. The noun pollution seems to be uncountable; consider using: #"much pollution", "a good deal of pollution"#.	可能的协议错误。“污染”这个名词似乎是不可数的；考虑使用：#"much pollution", "a good deal of pollution"#。
Possible agreement error. The noun #visiter# seems to be countable; consider using: #"Plenty of visiters"#.	可能的协议错误。名词#visiter#似乎是可数的；请考虑使用：#"Plenty of visiters"#。
Possible agreement error. You should probably use: #"(Arts) presents"#.	可能的协议错误。你应该使用：#"(Arts) presents"#。
Possible agreement error. You should probably use: #"Eat plants" or "Eats plant"#.	可能的协议错误。你应该使用：#"Eat plants" or "Eats plant"#。
Possible fragment. Please, verify.	可能的碎片。请核实一下。
Possible grammar error. Make sure that #'is I am going'# is correct.	可能的语法错误。确保#'is I am going'#是正确的。
Possible grammatical error. You used a past participle without using any required verb #('be' or 'have')#. Did you mean #"began"#?	可能的语法错误。使用过去分词时不使用任何必需的动词#('be' or 'have')#。你的意思是#"began"#吗？
Possible spelling mistake found	发现可能的拼写错误
Possible spelling mistake. Did you mean #"abilities"#, the plural form of the noun #'ability'#?	可能的拼写错误。你的意思是#"abilities"#，#'ability'#名词的复数形式？ 
Possible spelling mistake. Did you mean #"admitted"#, the past tense form of the verb #'admit'#?	可能的拼写错误。你的意思是#"admitted"#，动词#"admitted"#的过去时态形式吗？
Possible spelling mistake. Did you mean #"worse"#, the comparative form of the adjective #'ill'#?	可能的拼写错误。你的意思是#"worse"#，形容词#'ill'#的比较形式？
Possible spelling mistake. Did you mean #"worst"#, the superlative form of the adjective #'bad'#?	可能的拼写错误。你的意思是#"worst"#,#'bad'#这个形容词的最高级形式吗？
Possible typo. Did you mean #"A" or "He"#?	可能的键入。你的意思是#"A" or "He"#？
Possible typo. Did you mean: #"A" or "He"#?	可能的键入。你的意思是#"A" or "He"#？
Possible typo: apostrophe is missing. Did you mean #"activities'" or "activity's"#?	可能是拼写错误：缺少撇号。你的意思是#"activities'" or "activity's"#？
Possible typo: you repeated a whitespace	可能的拼写错误：您重复了空格
Possible typo: you repeated a word	可能的拼写错误：你重复了一个词
Possibly confused word: Did you mean #"message"# (= #communication, or what is communicated#) instead of #'massage'# (= #action of rubbing, kneading or hitting someone's body#)?	可能是混淆的词：你是指#"message"#（=#communication, or what is communicated#）而不是#'massage'#（=#action of rubbing, kneading or hitting someone's body#）？
Possibly wrong usage of #'Do'# in the question. Did you mean: #"can housework"#.	问题中#'Do'#的用法可能有误。你是说：#"can housework"#？
Probable usage error. Use #"Because I"# instead.	可能的使用错误。用#"Because I"#代替。
Probably a noun is missing in this part of the sentence.	可能句子的这一部分缺少一个名词。
Probably an incorrect phrase. Use #'the reason "is that"'#.	可能是不正确的词组。使用#'the reason "is that"'#。
Probably incorrect use of superlative #'worst'#. Consider using the comparative form instead.	可能不正确使用最高级的#'worst'#。考虑改用比较形式。
Put a space after the comma	在逗号后加一个空格
Reduce redundancy by using #"little"# or #"bit"#.	使用#"little"#或#"bit"#来减少冗余。
Redundant phrase. Consider using #"10 o'clock" or "10 am"#.	多余的短语。考虑使用#"10 o'clock" or "10 am"#。
Some style guides suggest that commas should set off the year in a month-day-year date: #"1985,"#.	一些风格指南建议逗号应在一个月一天的年份日期内开始年份：“#"1985,"#。 
Specify a number, remove phrase, or simply use #"many"# or #"numerous"#	指定一个数字，删除词组，或者简单地使用#"many"#或#"numerous"#
Substandard usage of #'let'#. The standard is: #"Let's not"#.	#'let'#的使用不规范。标准是：#"Let's not"#。
The adjective #afraid# is used with #'of'#: #"afraid of examinations"#.	形容词#afraid#与#'of'#连用,#"afraid of examinations"#。
The adverb #'Always'# is usually not used at the beginning of a sentence.	副词#'Always'#通常不用于句子的开头。
The adverb #'Always'# is usually not used at the end of a sentence.	副词#'Always'#通常不用于句尾。
The adverb #'Always'# usually goes after the verb #'are'#.	副词#'Always'#通常在动词#“are”#之后。
The adverb #'Sometimes'# is usually put before the verb #'Second'#.	副词#'Sometimes'#通常放在动词#'Second'#之前。
The adverb #'always'# is usually put after the verb #'am'#.	副词#“always”#通常放在动词#“am”#的后面。
The adverb #'always'# is usually put between #'have'# and #'fan'#.	副词#“always”#通常放在#“have”#和#“fan”#之间。
The adverb #'often'# is usually put between #'have' and 'come'#.	副词#'often'#通常放在#'have' and 'come'#之间。 
The adverb #'seldom'# is usually not used at the end of a sentence.	副词#'seldom'#通常不用于句尾。
The adverb #'sometimes'# is usually put between #'will' and 'be'#.	副词#'sometimes'#通常放在#'will' and 'be'#之间。
The adverb #'usually'# is usually put between #'have'# and #'till'#.	副词#'usually'#通常放在#'have'#和#'till'#之间。
The article is probably missing here: #"In the 1900s"#.	可能缺失了冠词：#"In the 1900s"#。
The comma is probably incorrect: #"Chinese"#	逗号可能不正确：#"Chinese"#
The comma is probably missing here: #"100, I"#.	这里可能缺少逗号：#"100, I"#。
The date #Dec 31, 2006# is not #a Friday#, but #a Sunday#.	#Dec 31, 2006#不是#a Friday#，而是#a Sunday#。
The extreme adjective for #bad# is #'"awful"', or '"terrible"', or '"horrible"'#.	#bad#的极端形容词是#'"awful"'，或'"terrible"'，或'"horrible"'#。
The genitive is possibly missing.	可能是缺少了和蔼。
The noun should be probably in the plural form: #"backs"#.	名词应该是复数形式：#"backs"#。
The noun should be probably in the singular form: #"(poetries)"#?	名词应该是单数形式：#"(poetries)"#？
The phrase #'A tremendous of'# is not correct. Use a noun, not an adjective, between #'A' and 'of'#.	短语#'A tremendous of'#不正确。在#'A' and 'of'#之间使用名词，而不是形容词。
The phrase #'Most every'# is colloquial. In formal/ written English you should avoid it. Use #"almost every"# instead!	短语#'Most every'#是口语化的。在正式/书面英语中，应避免使用。用#"almost every"#代替！
The phrase #'a ahead of'# is not correct. Use a noun, not an adjective, between #'a'# and #'of'#.	短语#'a ahead of'#不正确。使用名词，而不是形容词，介于#'a'# and #'of'#之间。
The phrase #'most every'# is colloquial. In formal/ written English you should avoid it. Use #"almost every"# instead!	短语#'most every'#是口语化的。在正式/书面英语中，应避免使用。用#"almost every"#代替！
The phrase #'most everyone'# is colloquial. In formal/ written English you should avoid it. Use #"almost everyone"# instead!	#'most everyone'#这个短语很口语化。在正式/书面英语中，应避免使用。用#"almost everyone"#代替！
The phrase #'regarding to'# is not correct. Use #"regarding"# or #"regard to"#.	短语#'regarding to'#不正确。使用#"regarding"#或#"regard to"#。
The pronoun #'I'# must be used with a non-third-person form of a verb: #"amn't", "aren't", "arenn't"#	代词#'I'#必须与动词的非第三人称形式一起使用：#"amn't", "aren't", "arenn't"#
The pronoun #'Nobody'# is usually used with a third-person or a past tense verb: #"doesn't", "didn't"#.	代词#'Nobody'#通常与第三人称或过去时动词连用：#"doesn't", "didn't"#。
The pronoun #I# must be used with #"Am"#.	代词#I#必须与#"Am"#连用。
The singular proper name #'Day'# must be used with a third-person or a past tense verb: #"brings", "brought"#.	单数专有名称#'Day'#必须与第三人称或过去时动词一起使用：#"brings", "brought"#。
The singular proper name #Englsh# must be used with #"is"#.	单数专有名称#Englsh#必须与#"is"#一起使用。
The usual collocation for #"accompany"# is #"by,"# not #"with."# It is better to say this: #"accompanied by"#.	#"accompany"#的常见搭配方式是#"by,"#，不是#"with."#，最好这样说：#"accompanied by"#。
The usual collocation for #"advertisement"# is #"for"# not #"of"#. Did you mean #"advertisement for"#.	通常，#"advertisement"#的搭配是#"for"#“不是”#"of"#。你的意思是#"advertisement for"#。
The usual collocation for #"afraid"# is #"of"# not #"from"#. Did you mean #"afraid of"#.	#"afraid"#的通常搭配是#"of"#不是#"from"#。你是说#"afraid of"#。
The usual collocation for #"afternoon"# is #"in"#. Revise: #"in the afternoon"#.	通常#"afternoon"#的搭配是#"in"#。修改：#"in the afternoon"#。
The usual collocation for #"aims"# is #"at"# not #"on"#. Did you mean #"aims at"#.	#"aims"#的常见搭配是#"at"#不是#"on"#。你的意思是#"aims at"#。
The usual collocation for #"came"# is #"by"#. Did you mean #"We came by Train"#.	#"came"#的通常搭配是#"by"#，你是说#"We came by Train"#。
The usual collocation for #"careful"# is #"with"# not #"for"#. Did you mean #"careful with"#.	#"careful"#通常与#"with"#搭配而不是#"for"#。你的意思是#"careful with"#。
The usual collocation for #"die"# is #"of"# not #"from"#. Did you mean #"die of"#.	#"die"#的常见搭配是#"of"#而不是#"from"#。你的意思是#"die of"#。 
The usual collocation for #"evening"# is #"in"#. Revise: #"in the evening"#.	#"evening"#通常的搭配是#"in"#。修改：#"in the evening"#。
The usual collocation for #"near"# is #"to"# not #"from"#. Did you mean simply #"near to"# or #"further from"#.	#"near"#的常见搭配是#"to"#而不是#“from”#。你的意思是#"near to"#还是#"further from"#。 
The usual collocation for #"tired"# is #"of"# or #"from"# not #"about"#. Did you mean #"tired of"# or #"tired from"#.	#"tired"#的通常搭配是#"of"#或#"from"#而不是#"about"#。你的意思是#"tired of"# or #"tired from"#。 
The usual collocation for #"to" and "a trip"# is #"to on a trip".# Did you mean #"go on a trip"?#	#"to"和"a trip"#通常的搭配是#"to on a trip"#。你是说#"go on a trip"？#
The usual collocation for #"weekend"# is #"over"# or #"during"#. Revise: #"over the weekend"# or #"during the weekend"#.	通常#"weekend"#的搭配是#"over"#或#"during"#。修改：#"over the weekend"#或#"during the weekend"#。
The usual collocation for an activity ending in #"-ing"# is #"go"# not #"do" or "play"# Revise: #"going volunteering", "gonna volunteering"#.	以#"-ing"#结尾的活动的常见搭配是#"go"#而不是#"do"或"play"#。修订：#“Going volunteing”、“Gong volunteing”#。
The usual collocation for an activity that does not end in #"-ing"# and is not something you can win is #"do"# not #"go"# or #"play".# Revise: #"did exercise", "do exercise", "does exercise", "doing exercise", "done exercise"#.	对于一个不以#“-ing”#结尾，也不是你能赢的活动，通常的搭配是#"do"#而不是#"go"#或#"play"#。修改：#"did exercise", "do exercise", "does exercise", "doing exercise", "done exercise"#
The usual collocation for an activity that does not end in #"-ing"# and is not something you can win is #"do"# not #"go"# or #"play."# Revise: #"doing exercise"#.	对于一个没有以#"-ing"#而不是你能赢的东西的活动，通常的搭配是#"do"#而不是#"go"#或#"play"#。修改：#"doing exercise"#
The usual collocation for an activity that does not end in #"-ing"# and is something you can win is #"play"# not #"do"# or #"go."# Revise: #"play ball"#.	对于一个不以#"-ing"#结尾的活动，通常的搭配是#"play"#而不是#"do"#或#"go"#。修改：#"play ball"#。 
The usual collocation for #technology# is #"on,"# not #"in."# It is better to say this: #"on the Internet"#.	#technology#的常见搭配是#"on"#，而不是，#“in”#。最好这样说：#"on the Internet"#。
The usual collocation for word #"interest"# is #"in"# not #"about."# Revise: #"more interest in"#.	#"interest"#一词的常见搭配是#"in"#而不是#"about"#,修改：#"more interest in"#。
The usual collocations for #"responsable"# is #"responsable for"#. Did you mean #"responsable for"# or #"in charge of"#?	#"responsable"#的通常搭配是#"responsable for"#。你的意思是#"responsable for"#还是#"in charge of"#？
The usual preposition for #"a trip"# with a named destination is #"to"#. Did you mean #"a trip to"#?	带指定目的地的#"a trip"#的惯用介词是#"to"#。你是说#"a trip to"#？
The usual preposition for #"afternoon"# is #'in'# not #"on"#. Try it like this:  #"in the afternoon"#.	通常#"afternoon"#的介词是#“in”#而不是#“on”#。试着这样做：#"in the afternoon"#。
The usual preposition for #"birthdays"# is #"on"#.  Revise: #"on His Birthday"#.	通常，#"birthdays"#的介词是#“on”#。修改：#"on His Birthday"#。
The usual preposition for #"concentrate"# is #"on"# not #"all"#.  Revise: #"concentrated on the time"#.	通常#"concentrate"#的介词是#“on”#而不是#“all”#。修改：#"concentrated on the time"#。
The usual preposition for #"contribution"# is #"to"#. Did you mean #"contribution to"#.	#"contribution"#常用的介词是#"to"#。你的意思是#"contribution to"#。
The usual preposition for #"evening"# is #'in'# not #"on"#. Try it like this:  #"in the evening"#.	#"evening"#的常用介词是#“in”#而不是#“on”#。试着这样做：#"in the evening"#。 
The usual preposition for #"island"# is #"on"# not #"in"#.  Revise: #"on an island"#.	通常，#“island”#的介词是#“on”#而不是#“in”#。修改：#"on an island"#。
The usual preposition for #"the weekend"# is #"on"#. Revise: #"on the weekend"# for American English, or #"at the weekend"# for British English.	#"the weekend"#的惯用介词是#"on"#，美国英语改为#“on the weekend”#，英国英语改为#“at the weekend”#。
The usual preposition for #"weekends"# is #"on."# Revise: #"on weekends"# for American English, or #"at the weekend"# for British English.	#"weekends"#的惯用介词是#“on”#，美国英语改为#“on weeks”#，英国英语改为#“at the weekend”#。
The usual preposition for #Earth# is #"on"#. Did you mean #"live on Earth"#?	#Earth#通常的介词是#"on"#。你的意思是#"live on Earth"#？
The usual preposition for #team membership# is #"on"# not #"in"#. Try it like this:  #"on the school's basketball team"#.	#team membership#的常用介词是#“on”#而不是#“in”#。试着这样做：#"on the school's basketball team"#。
The usual preposition for this expression is #"at"#. Did you mean, #"good at learning"#?	这个表达式常用的介词是#"at"#。你是说#"good at learning"#？
The usual preposition to follow #"difficult"# is #'for"# when followed by a pronoun. #"Difficult"# and #"to"# only appear together when #"to"# forms part of an infinitive structure.  Did you mean #"difficult for you"#?	通常在#"difficult"#后接的介词是#'for"#后接代词。#"Difficult"#和#"to"#只在#"to"#构成不定式结构的一部分时一起出现。你的意思是#"difficult for you"#吗？
The usual preposition to use with #"kind"# is "to." Did you mean "kind to"?	通常与#"kind"#连用的介词是"to."。你的意思是"kind to"？
The usual prepositions to use after #"consequence"# is #"of"# or #'for'# not #"on"#. Did you mean #"consequence of"# or #"consequence for"#?	#"consequence"#后面常用的介词是#"of"#或#'for'#而不是#"on"#。你的意思是#"consequence of"#还是#"consequence for"#？
The usual prepositions to use when in contact with the #side# is #"on"# not #"in"#. Did you mean #"on the right side"#?	与#side#接触时常用的介词是#"on"#而不是#“in”#。你是说#"on the right side"#？
The usual prepositions to use when #surrounded# is #"in"# not #"on"#. Did you mean #"in the center"#?	#surrounded#常用的介词是#"in"#而不是#“on”#。你的意思是#"in the center"#？
The usual proposition after #"arrive"# is #"at"# not #"on"#. Did you mean #"arrive at"#?	#"arrive"#后的通常建议是#"at"#而不是#"on"#。你是说#"arrive at"#？
The verb #'Can'# requires the base form of the verb: #"sport"#	动词#'Can'#需要动词的基本形式：#"sport"#
The verb #'Didn't'# requires base form of this verb: #"have"#	动词#'Didn't'#需要此动词的基本形式：#"have"#
The verb #'Do'# is plural. Did you mean: #"this does"#?	动词#'Do'#是复数。你的意思是：#"this does"#？
The verb #'Doesn't'# requires base form of this verb: #"like"#	动词#'Doesn't'#需要这个动词的基本形式：#"like"#
The verb #'Enjoys'# is used with the gerund form: #"Enjoys reading"#.	动词#'Enjoys'#与动名词形式一起使用：#"Enjoys reading"#。
The verb #'Liking'# is a stative verb and sometimes the progressive form is not correct. Try a simple form instead.	动词#'Liking'#是一个定语动词，有时累进形式不正确。尝试一个简单的表单。
The verb #'Should'# requires the base form of the verb: #"be"#	动词#'Should'#应该需要动词的基本形式：#"be"#
The verb #'Will'# requires the base form of the verb: #"get"#	动词#'Will'#需要动词的基本形式：#"get"#
The verb #'advise'# is plural. Did you mean: #"This advises"#?	动词#'advise'#是复数。你的意思是：#"This advises"#？
The verb #'advises'# is singular. Did you mean: #"This advises" or "these advise"#?	动词#'advises'#是单数。你的意思是：#"This advises" or "these advise"#？
The verb #'agreeing'# is a stative verb and sometimes the progressive form is not correct. Try a simple form instead.	动词#'agreeing'#是一个定语动词，有时累进形式不正确。尝试一个简单的表单。
The verb #'asks'# is singular. Did you mean: "This asks" or "these ask"?	动词#'asks'#是单数。你是说："This asks" or "these ask"？
The verb #'avoid'# is used with the gerund form: #"avoid facing"#.	动词#'avoid'#与动名词形式一起使用：#"avoid facing"#。
The verb #'behaves'# is singular. Did you mean: #"This behaves" or "these behave"#?	动词#'behaves'#是单数。你是说：#"This behaves" or "these behave"#？
The verb #'can'# requires base form of the verb: #"class"#	动词#'can'#需要动词的基本形式：#"class"#
The verb #'can'# requires the base form of the verb: #"accord"#	动词#'can'#需要动词的基本形式：#"accord"#
The verb #'concerning'# is a stative verb and sometimes the progressive form is not correct. Try a simple form instead.	动词#'concerning'#是一个定语动词，有时累进形式不正确。尝试一个简单的表单。
The verb #'contains'# is singular. Did you mean: #"This contains"# or #"those contain"#?	动词#'contains'#是单数。你的意思是：#"This contains"# or #"those contain"#？
The verb #'could'# requires the base form of the verb: #"accept"#	动词#'could'#需要动词的基本形式：#"accept"#
The verb #'did'# requires the base form of the verb: #"ask"#	动词#'did'#需要动词的基本形式：#"ask"#
The verb #'girts'# is singular. Did you mean: #"This girts" or "these girt"#?	动词#'girts'#是单数。你是说：#"This girts" or "these girt"#？
The verb #'happen'# usually requires the preposition #"to"#.	动词#'happen'#通常需要介词#"to"#。
The verb #'has'# is singular. Did you mean: #"This has"# or "These have", "These haven"?	动词#'has'#是单数。你的意思是：#"This has"# or "These have", "These haven"？
The verb #'hearing'# is a stative verb and sometimes the progressive form is not correct. Try a simple form instead.	动词#'hearing'#是一个定语动词，有时累进形式不正确。尝试一个简单的表单。
The verb #'help'# is used with infinitive: #"to act" or "act"#.	动词#'help'#与不定式连用：#"to act" or "act"#。
The verb #'is'# is singular. Did you mean: #"This is" or "These am", "These are", "These aren"#?	动词#'is'#是单数。你的意思是：#"This is" or "These am", "These are", "These aren"#？
The verb #'ll'# requires the base form of the verb: #"be"#	动词#'ll'#需要动词的基本形式：#"be"#
The verb #'may'# requires the base form of the verb: #"bite"#	动词#'may'#需要动词的基本形式：#"bite"#
The verb #'requires'# is singular. Did you mean: "This requires" or "these require"?	动词#'requires'#是单数。你是说："This requires" or "these require"？
The verb #'riles'# is singular. Did you mean: #"This riles" or "these rile"#?	动词#'riles'#是单数。你是说：#"This riles" or "these rile"#？
The verb #'should'# requires base form of the verb: #"teach"#	动词#'should'#应该需要动词的基本形式：#"teach"#
The verb #'suggests'# is singular. Did you mean: #"This suggests" or "these suggest"#?	动词#'suggests'#是单数。你是说：#"This suggests" or "these suggest"#？
The verb #'to ask someone'# does not require a preposition.	动词#'to ask someone'#不需要介词。
The verb #'to depend'# requires the preposition #'(up)on'#: #"Depend on"#.	动词#'to depend'#需要介词#'(up)on'#：#"Depend on"#。
The verb #'to rely'# requires the preposition #'(up)on'#: #"relied on"#.	动词#'to rely'#需要介词#'(up)on'#：#"relied on"#。
The verb #'to tell someone'# does not require a preposition.	动词#'to tell someone'#不需要介词。
The verb #'will'# requires the base form of the verb: #"absorb"#	动词#'will'#需要动词的基本形式：#"absorb"#
The verb #'worry'# does not normally take the preposition #'for'#. Did you mean #"worried about"#?	动词#'worry'#通常不采用介词#'for'#。你是说#"worried about"#吗？
The verb #'would'# requires the base form of the verb: #"appreciate"#	动词#'would'#需要动词的基本形式：#"appreciate"#
The verb after #"to"# should be in the base form: #"agree"#.	#"to"#后面的动词应采用基本形式：#"agree"#。
The word #'100-metre'# is an adjective (SI unit of measurement), but the spelling is not correct American English.	#'100-metre'#是一个形容词（国际单位制计量单位），但拼写不正确的美国英语。
The word #'1200-meters'# is an adjective (SI unit of measurement), but the spelling is not correct. Do not use a plural adjective. Refer to section 5.3.3 in 'The International System of Units (SI)'.	#'1200-meters'#是一个形容词（国际单位制计量单位），但拼写不正确。不要用复数形容词。参见“国际单位制（SI）”第5.3.3节。
The words #"come in"# and #"come to"# have different meanings. #"Come in my office"# means #"have an orgasm in my office."# #"Come to"# or #"Come into"# means #"enter."# Did you mean #"come to"# or "come into"?	 #"come in"#和#"come to"#两个词有不同的含义。#"Come in my office"#是指#"have an orgasm in my office."##"Come to"#或#"Come into"#是指#"enter."#。你是指#"come to"#或"come into"？
There isn't usually a preposition after #"enter"#. Did you mean #"enter an new"#.	在#"enter"#之后通常没有介词。你的意思是#"enter an new"#。
There isn't usually a preposition before #"Somewhere"#. Did you mean #"go Somewhere"#.	在#"Somewhere"#之前通常没有介词。你的意思是#"go Somewhere"#吗？
There should be no space here: #"o'clock"#.	这里应该没有空间：#"o'clock"#。
This adjective uses the short comparatives form.	这个形容词使用短的比较级形式。
This contractions is incorrect. Please, check the apostrophe position.	这种收缩是不正确的。请检查撇号位置。
This expression is normally spelled as one or with hyphen.	此表达式通常拼写为一个或带连字符。
This is a collocation error. Use #"in"# for rooms. Revise: #"in the Room"#.	这是并置错误。房间使用#"in"#。修改：#"in the Room"#。
This is a collocation error. You do not need a preposition after #"ask'#. Remove it: #"ask"#.	这是并置错误。#"ask'#后不需要介词。删除它：#"ask"#。
This is a non-standard collocation. Normally, #"last night"# is used.	这是一个不标准的搭配。通常使用#"last night"#。
This phrase can sound awkward in English. Consider using #"in my opinion"# or #"I think"#.	这个短语在英语中听起来很难听。考虑使用#"in my opinion"#或#"I think"#。
This phrase is duplicated. You should probably leave only #"After days"#.	这个短语是重复的。你应该在#"After days"#才离开。
This phrase is nonstandard. Did you mean #"all in all"# (=#after all, nevertheless#)?	这个短语不规范。你的意思是#"all in all"#吗（#after all, nevertheless#）？
This phrase is probably grammatically incorrect. Write #"These"# instead.	这个短语可能语法错误。改为写#"These"#。
This phrase is redundant. Consider using #"because"#.	这个短语是多余的。考虑使用#"because"#。
This phrase is used with #'be'#: #"be 1200 years old".#	这个短语与#'be'#：#"be 1200 years old".#连用。
This sentence does not start with an uppercase letter	这句话不是以大写字母开头的
This sounds awkward in English. The standard is #"the question of why"#.	这在英语中听起来很尴尬。标准是#"the question of why"#。
This verb is used with the infinitive: #"to arrive"#	这个动词与不定式连用：#"to arrive"#
This word is considered offensive.	这个词被认为是冒犯性的。
This word is normally spelled as one.	这个词通常拼成一个。
This word is normally spelled with hyphen.	这个词通常用连字符拼写。
This word is usually spelt together: #"eyesight"#.	这个词通常拼在一起：#"eyesight"#。
This word is usually written together. Did you mean #"without"#?	这个词通常写在一起。你是说#"without"#？
Three successive sentences begin with the same word. Consider rewording the sentence or use a thesaurus to find a synonym.	三个连续的句子以同一个词开头。考虑改写句子或使用同义词库查找同义词。
Two consecutive dots	两个连续点
Two modal verbs connected. Do you mean: #"can, could", "can" or "could"#?	连接两个情态动词。你的意思是：#"can, could", "can" or "could"#？
Two successive sentences begin with the same adverb. Consider rewording the sentence or use a thesaurus to find a synonym.	两个连续的句子以同一个副词开头。考虑改写句子或使用同义词库查找同义词。
Uncountable nouns are usually not used with an indefinite article. Use simply #"English news"#.	不可数名词通常不与不定冠词连用。使用简单的#"English news"#。
Unless you mean #"in a political party,"# the usual preposition for a party is #"at."# Did you mean, #"at a party"#?	除非你的意思是#"in a political party,"#，否则一个政党通常的介词是#“at”#。你的意思是#"at a party"#？
Unpaired symbol: #'('# seems to be missing	未配对的符号：#'('#似乎缺失了
Use #"(Active)"# to make a comparison with this adjective.	用#"(Active)"#与这个形容词作比较。
Use #"A"# instead of #'An'# if the following word doesn't start with a vowel sound, e.g. #'a sentence', 'a university'#	如果以下单词不是以元音开头，例如#'a sentence', 'a university'#，则使用#"A"#而不是#'An'#。
Use #"An"# instead of #'A'# if the following word starts with a vowel sound, e.g. #'an article', 'an hour'#	如果以下单词以元音开头，则使用#"An"#而不是#'A'#，例如#'an article', 'an hour'#
Use #"Englisher"# to make a comparison with this adjective.	用#"Englisher"#来比较这个形容词。
Use #"a Million"# or use a number before #'Million'#.	使用#"a Million"#或使用#'Million'#之前的数字。
Use #"an"# instead of #'a'# if the following word starts with a vowel sound, e.g. #'an article', 'an hour'#	如果以下单词以元音开头，例如#'an article', 'an hour'#等，请使用#"an"#而不是#“a”#。 
Use #"beautifuler"# to make a comparison with this adjective.	用#"beautifuler"#来和这个形容词作比较。
Use #"best"# if you mean to express an extreme with this adjective.	如果你想用这个形容词表达一个极端，就用#"best"#。
Use #"better"# to make a comparison with this adjective.	用#"better"#与这个形容词作比较。
Use #"between" + "and"# not #"to."#  Try this: #"Between 18 and 1895"#.	使用#"between" + "and"#而不是#"to."# 尝试一下：#"Between 18 and 1895"#。
Use #"bigger"# to make a comparison with this adjective.	用#"bigger"#这个形容词作比较。
Use #"good at"# to mean #"skilled"# with school subjects. Try this: #"best at English"#.	用#"good at"#来表示对学校科目的#"skilled"#。试试这个：#"best at English"#。
Use #"greater"# to make a comparison with this adjective.	用#"greater"#与这个形容词作比较。
Use #"less", "lesser", "littler"# to make a comparison with this adjective.	用#"less", "lesser", "littler"#与这个形容词作比较。
Use #"longer"# to make a comparison with this adjective.	用#"longer"#与这个形容词作比较。
Use #"lovelier"# to make a comparison with this adjective.	用#"lovelier"#来比较这个形容词。
Use #"lowest"# if you mean to express an extreme with this adjective.	如果你想用这个形容词表达一个极端，用#"lowest"#这个词。
Use #"many"# with countable nouns.	对可数名词使用#"many"#。
Use #"much" or "little"# with uncountable nouns.	对不可数名词使用#"much" or "little"#。
Use #"neatest"# if you mean to express an extreme with this adjective.	如果你想用这个形容词表达一个极端，用#"neatest"#。
Use #"patienter"# to make a comparison with this adjective.	用#"patienter"#与这个形容词作比较。
Use #"the"# with the superlative.	用最高级的#"the"#。
Use #"thinner"# to make a comparison with this adjective.	用#"thinner"#与这个形容词作比较。
Use #"well on"# with #"examinations"#. Try this: "do well on examinations".	用#"well on"#和#"examinations"#。试一试：“考试考得好”。
Use #"well on"# with #"exams"#. Try this: #"do well on exams"#.	使用#"well on"#和#"exams"#。试试这个：#“考得好”#。
Use #"worse"# to make a comparison with this adjective.	用#"worse"#来比较这个形容词。
Use a comma before #'and'# if it connects two independent clauses (unless they are closely connected and short).	如果连接两个独立的从句，请在#'and'#之前使用逗号（除非它们紧密相连且简短）。
Use a plural noun after #'some'# or use #"staff members"#.	在#'some'#后面使用复数名词或使用#"staff members"#。
Use a singular form of the numeral here: #"0 thousand"#.	此处使用数字的单数形式：#"0 thousand"#。
Use either #"equally"# or #"as"# on its own. When comparing two nouns, use #"just as"#.	单独使用#"equally"#或#"as"#。比较两个名词时，使用#"just as"#。
Use first person plural verb with #'we': "are", "were"#.	用第一人称复数动词和#'we': "are", "were"#。
Use only #"best"# (without #'more'#) when you use the superlative.	当你使用最高级时，只使用#"best"#（没有#'more'#）。
Use only #"taller"# (without #"More"#) when you use the comparative.	当你使用比较级时，只使用#"taller"#（没有#'more'#）。
Use past participle here: #"sawed", "sawn", "seen".#	此处使用过去分词：#"sawed", "sawn", "seen".#。
Use second person verb with #'you'#: #"are" or "were"#.	#'you'#用第二人称动词: #"are" or "were"#。
Use third-person plural verb with #'they'#: #"are", "were"#.	#“they”#用第三人称复数动词和：#"are", "were"#。
Use third-person verb with #'He'#: #"is" or "was"#.	#“he”#用第三人称动词：#"is" or "was"#。
Verbs #'advise'# and #'remind'# are used with infinitive: #"to visit"#.	动词#'advise'#和#'remind'#与不定式#"to visit"#连用。
When a number forms part of an adjectival compound, use a hyphen: #"0-meter"#	当一个数字构成一个形容词复合词的一部分时，使用连字符：#"0-meter"#
When a number forms part of an adjectival compound, use hyphens: #"thirteen-year-old"#	当一个数字构成一个形容词复合词的一部分时，使用连字符：#"thirteen-year-old"#
When a person is directly addressed, a comma should set off the name: #"Also, please"#?	当一个人被直接称呼时，用逗号隔开他的名字：#"Also, please"#？
When referring to yourself and somebody else, put their name first. Also check whether the nominative form "I" is required here.	当提到你自己和别人时，把他们的名字放在第一位。还要检查这里是否需要提名表格“I”。
When specifying a month and year, the comma is unnecessary: #"April 2018".#	指定月份和年份时，不需要逗号：#"April 2018".#。
When we speak of types of meals, the article is not required: #"Have breakfast"#	当我们谈到饭菜的种类时，不需要冠词：#"Have breakfast"#
With the word #'someone'# in a subjunctive clause, use the base form of a verb: #"interest"#.	在虚拟从句中使用#'someone'#这个词时，使用动词的基本形式：#"interest"#。
Writing for an international audience? Consider adding the metric equivalent.	为国际观众写作？考虑添加公制等效值。
Wrong phrase. Use #"1:00"# or #"1 O'clock"#.	错误的短语。使用#"1:00"#或#"1 O'clock"#。
Wrong phrase; 'o'clock is used only at the full hour. Use simply #"2:40"# instead.	错误的短语；‘点钟’只在整小时使用。只需使用#"2:40"#即可。
You can apply for #a job or welfare#, but you apply to #a college#. Revise: #"apply to this college"#.	你可以申请#工作或福利#，但你可以申请#大学#。修订：#"apply to this college"#。
You miss the verb here. You should rather write: #"I'm afraid"#.	你错过了这里的动词。你应该写下：#"I'm afraid"#。
You should probably use #"Does"#.	您可能应该使用#"Does"#。
You used a negation after a negated contracted verb. Did you mean simply #"can't"#?	你在否定的收缩动词后使用否定。你的意思是#"can't"#吗？
You used an adverb #('about')# instead an adjective, or a noun #('Huck')# instead of another adjective.	你用副词#('about')#代替形容词，或者用名词#('Huck')#代替另一个形容词。
#nowadays# is used without #'in'#. Use simply: #"nowadays"#.	#nowadays#不用#'in'#。简而言之：#"nowadays"#。
